Sr No.,Movie Name,genre,Budget,Revenue,Profit,Release Year
1,Jurassic World,Action,150000000,1513528810,1363528810,2015
2,Mad Max: Fury Road,Action,150000000,378436354,228436354,2015
3,Insurgent,Thriller,110000000,295238201,185238201,2015
4,Star Wars: The Force Awakens,Action,200000000,2068178225,1868178225,2015
5,Furious 7,Action,190000000,1506249360,1316249360,2015
6,The Revenant,Drama,135000000,532950503,397950503,2015
7,Terminator Genisys,Action,155000000,440603537,285603537,2015
8,The Martian,Drama,108000000,595380321,487380321,2015
9,Minions,Comedy,74000000,1156730962,1082730962,2015
10,Inside Out,Comedy,175000000,853708609,678708609,2015
11,Spectre,Action,245000000,880674609,635674609,2015
12,Jupiter Ascending,Action,176000003,183987723,7987720,2015
13,Ex Machina,Drama,15000000,36869414,21869414,2015
14,Pixels,Action,88000000,243637091,155637091,2015
15,Avengers: Age of Ultron,Action,280000000,1405035767,1125035767,2015
16,The Hateful Eight,Drama,44000000,155760117,111760117,2015
17,Taken 3,Action,48000000,325771424,277771424,2015
18,Ant-Man,Action,130000000,518602163,388602163,2015
19,The Hunger Games: Mockingjay - Part 2,Adventure,160000000,650523427,490523427,2015
20,Tomorrowland,Action,190000000,209035668,19035668,2015
21,San Andreas,Drama,110000000,470490832,360490832,2015
22,Fifty Shades of Grey,Drama,40000000,569651467,529651467,2015
23,The Big Short,Drama,28000000,133346506,105346506,2015
24,Mission: Impossible - Rogue Nation,Action,150000000,682330139,532330139,2015
25,Kingsman: The Secret Service,Action,81000000,403802136,322802136,2015
26,Spotlight,Drama,20000000,88346473,68346473,2015
27,Maze Runner: The Scorch Trials,Action,61000000,311256926,250256926,2015
28,Chappie,Action,49000000,102069268,53069268,2015
29,Goosebumps,Comedy,58000000,150170815,92170815,2015
30,Room,Drama,6000000,35401758,29401758,2015
31,The Good Dinosaur,Comedy,175000000,331926147,156926147,2015
32,Brooklyn,Drama,11000000,62076141,51076141,2015
33,Straight Outta Compton,Drama,28000000,201634991,173634991,2015
34,The Last Witch Hunter,Action,90000000,140396650,50396650,2015
35,The Age of Adaline,Drama,25000000,42629776,17629776,2015
36,Hardcore Henry,Action,10000000,14333790,4333790,2015
37,Home,Comedy,135000000,368871007,233871007,2015
38,The Lobster,Drama,4000000,9064511,5064511,2015
39,Carol,Drama,11800000,40272135,28472135,2015
40,The Intern,Comedy,35000000,194564672,159564672,2015
41,Everest,Drama,55000000,203427584,148427584,2015
42,Point Break,Action,105000000,133718711,28718711,2015
43,Burnt,Drama,20000000,36606743,16606743,2015
44,Self/less,Thriller,26000000,30523226,4523226,2015
45,Mortdecai,Comedy,60000000,30418560,-29581440,2015
46,Blackhat,Drama,70000000,17752940,-52247060,2015
47,Fantastic Four,Action,120000001,167977596,47977595,2015
48,Spy,Action,65000000,235666219,170666219,2015
49,Focus,Drama,50100000,153962963,103862963,2015
50,Hitman: Agent 47,Action,35000000,82347656,47347656,2015
51,In the Heart of the Sea,Drama,100000000,93820758,-6179242,2015
52,Creed,Drama,35000000,137935567,102935567,2015
53,Legend,Thriller,25000000,42972994,17972994,2015
54,The Peanuts Movie,Comedy,99000000,246233113,147233113,2015
55,Concussion,Drama,35000000,48623572,13623572,2015
56,The Night Before,Comedy,25000000,52395996,27395996,2015
57,Knock Knock,Drama,2500000,5214043,2714043,2015
58,Love the Coopers,Comedy,17000000,24000000,7000000,2015
59,The Walk,Drama,35000000,61181942,26181942,2015
60,Tracers,Drama,11000000,1863315,-9136685,2015
61,The Gift,Thriller,5000000,58978653,53978653,2015
62,Daddy's Home,Comedy,50000000,240360392,190360392,2015
63,The Little Prince,Adventure,64000000,97571250,33571250,2015
64,The Dressmaker,Drama,11930000,18340000,6410000,2015
65,The DUFF,Comedy,8500000,43528634,35028634,2015
66,The Boy Next Door,Thriller,4000000,50163103,46163103,2015
67,Scouts Guide to the Zombie Apocalypse,Comedy,15000000,14860766,-139234,2015
68,The Visit,Thriller,5000000,98450062,93450062,2015
69,Krampus,Comedy,15000000,61548707,46548707,2015
70,Dark Places,Drama,20000000,208588,-19791412,2015
71,No Escape,Action,5000000,54418872,49418872,2015
72,Dope,Drama,700000,17986781,17286781,2015
73,Woman in Gold,Drama,11000000,61619773,50619773,2015
74,Sisters,Comedy,30000000,105011053,75011053,2015
75,Project Almanac,Thriller,12000000,32248241,20248241,2015
76,The Transporter Refueled,Action,25000000,72629670,47629670,2015
77,Crimson Peak,Drama,55000000,74679822,19679822,2015
78,Secret in Their Eyes,Drama,19500000,32189727,12689727,2015
79,The SpongeBob Movie: Sponge Out of Water,Family,74000000,311594032,237594032,2015
80,Insidious: Chapter 3,Drama,10000000,104303851,94303851,2015
81,The Lady in the Van,Drama,6000000,41387687,35387687,2015
82,Victor Frankenstein,Drama,40000000,34227298,-5772702,2015
83,Freeheld,Drama,7000000,573335,-6426665,2015
84,Rock the Kasbah,Comedy,15000000,3020664,-11979336,2015
85,"Hello, My Name Is Doris",Drama,1000000,14444999,13444999,2015
86,The Lazarus Effect,Thriller,3300000,64110728,60810728,2015
87,The Gallows,Thriller,100000,42664410,42564410,2015
88,Jem and the Holograms,Drama,5000000,2333684,-2666316,2015
89,War Room,Drama,3000000,67790117,64790117,2015
90,Stonewall,Drama,13500000,187674,-13312326,2015
91,Interstellar,Drama,165000000,621752480,456752480,2014
92,Guardians of the Galaxy,Action,170000000,773312399,603312399,2014
93,Captain America: The Winter Soldier,Action,170000000,714766572,544766572,2014
94,John Wick,Action,20000000,78739897,58739897,2014
95,The Hunger Games: Mockingjay - Part 1,Thriller,125000000,752100229,627100229,2014
96,The Hobbit: The Battle of the Five Armies,Adventure,250000000,955119788,705119788,2014
97,Big Hero 6,Action,165000000,652105443,487105443,2014
98,The Imitation Game,Drama,14000000,233555708,219555708,2014
99,The Maze Runner,Action,34000000,348319861,314319861,2014
100,Gone Girl,Drama,61000000,369330363,308330363,2014
101,Divergent,Action,85000000,288747895,203747895,2014
102,X-Men: Days of Future Past,Action,250000000,746000000,496000000,2014
103,Lucy,Action,40000000,463360063,423360063,2014
104,Teenage Mutant Ninja Turtles,Action,125000000,477200000,352200000,2014
105,Nightcrawler,Drama,8500000,38697217,30197217,2014
106,Transformers: Age of Extinction,Action,210000000,245500000,35500000,2014
107,Whiplash,Drama,3300000,13993093,10693093,2014
108,The Amazing Spider-Man 2,Action,200000000,705717432,505717432,2014
109,Edge of Tomorrow,Action,178000000,370541256,192541256,2014
110,American Sniper,Action,58800000,542307423,483507423,2014
111,Exodus: Gods and Kings,Drama,140000000,268031828,128031828,2014
112,Godzilla,Action,160000000,529076069,369076069,2014
113,Maleficent,Action,180000000,758410378,578410378,2014
114,The November Man,Action,15000000,32556119,17556119,2014
115,How to Train Your Dragon 2,Action,145000000,609123048,464123048,2014
116,The Expendables 3,Action,90000000,206172544,116172544,2014
117,The Lego Movie,Action,60000000,469160692,409160692,2014
118,Seventh Son,Adventure,95000000,114178613,19178613,2014
119,Into the Woods,Comedy,50000000,212902372,162902372,2014
120,300: Rise of an Empire,Action,110000000,337580051,227580051,2014
121,The Giver,Drama,25000000,66980456,41980456,2014
122,22 Jump Street,Action,50000000,188441614,138441614,2014
123,Paddington,Comedy,55000000,259207227,204207227,2014
124,Cake,Drama,7000000,2360281,-4639719,2014
125,Chef,Comedy,11000000,45967935,34967935,2014
126,Left Behind,Action,16000000,19682924,3682924,2014
127,A Most Violent Year,Drama,20000000,12007070,-7992930,2014
128,Noah,Drama,125000000,362637473,237637473,2014
129,The Judge,Drama,50000000,83719388,33719388,2014
130,Step Up All In,Drama,45000000,86165646,41165646,2014
131,Inherent Vice,Drama,20000000,11110975,-8889025,2014
132,RoboCop,Action,120000000,239379423,119379423,2014
133,Sin City: A Dame to Kill For,Thriller,65000000,39407616,-25592384,2014
134,Rio 2,Comedy,103000000,500188435,397188435,2014
135,The Monuments Men,Drama,70000000,154984035,84984035,2014
136,Unbroken,Drama,65000000,163442937,98442937,2014
137,St. Vincent,Comedy,13000000,54837234,41837234,2014
138,The Signal,Thriller,4000000,600896,-3399104,2014
139,Planes: Fire & Rescue,Comedy,50000000,151165787,101165787,2014
140,No Good Deed,Thriller,13200000,53830415,40630415,2014
141,"As Above, So Below",Thriller,5000000,40100000,35100000,2014
142,"I, Frankenstein",Thriller,65000000,71154592,6154592,2014
143,The Babadook,Drama,2000000,6676471,4676471,2014
144,Winter's Tale,Drama,60000000,30800231,-29199769,2014
145,The Water Diviner,Drama,22500000,15520023,-6979977,2014
146,"Alexander and the Terrible, Horrible, No Good, Very Bad Day",Comedy,28000000,100654149,72654149,2014
147,Big Game,Action,8500000,7500000,-1000000,2014
148,Million Dollar Arm,Drama,25000000,38307627,13307627,2014
149,Veronica Mars,Drama,6000000,3485127,-2514873,2014
150,Barefoot,Drama,6000000,15071,-5984929,2014
151,The Zero Theorem,Drama,8500000,770706,-7729294,2014
152,Decoding Annie Parker,Drama,2000000,48390,-1951610,2014
153,Dolphin Tale 2,Drama,36000000,52424533,16424533,2014
154,Heaven is for Real,Drama,12000000,101332962,89332962,2014
155,Song One,Drama,6000000,32251,-5967749,2014
156,Moms' Night Out,Comedy,5000000,10429707,5429707,2014
157,The Gambler,Drama,25000000,39171130,14171130,2014
158,God's Not Dead,Drama,17000000,29789000,12789000,2014
159,Star Wars,Action,11000000,775398007,764398007,1977
160,The Spy Who Loved Me,Action,14000000,185438673,171438673,1977
161,Avatar,Action,237000000,2781505847,2544505847,2009
162,Inglourious Basterds,Drama,70000000,319131050,249131050,2009
163,Harry Potter and the Half-Blood Prince,Adventure,250000000,933959197,683959197,2009
164,Up,Comedy,175000000,731342744,556342744,2009
165,Terminator Salvation,Drama,200000000,371353001,171353001,2009
166,District 9,Action,30000000,210819611,180819611,2009
167,Sherlock Holmes,Drama,90000000,524028679,434028679,2009
168,(500) Days of Summer,Drama,7500000,60722734,53222734,2009
169,The Hangover,Comedy,35000000,459270619,424270619,2009
170,2012,Action,200000000,769653595,569653595,2009
171,Angels & Demons,Thriller,150000000,356613439,206613439,2009
172,The Princess and the Frog,Romance,105000000,267045765,162045765,2009
173,The Blind Side,Drama,29000000,309208309,280208309,2009
174,Zombieland,Comedy,23600000,102391382,78791382,2009
175,The Twilight Saga: New Moon,Drama,50000000,709827462,659827462,2009
176,He's Just Not That Into You,Drama,40000000,177259441,137259441,2009
177,G.I. Joe: The Rise of Cobra,Action,175000000,302469017,127469017,2009
178,The Proposal,Drama,40000000,317375031,277375031,2009
179,The Ugly Truth,Comedy,38000000,205298907,167298907,2009
180,Cloudy with a Chance of Meatballs,Comedy,100000000,242988466,142988466,2009
181,Fantastic Mr. Fox,Comedy,40000000,46471023,6471023,2009
182,Coraline,Family,60000000,124596398,64596398,2009
183,Night at the Museum: Battle of the Smithsonian,Action,150000000,413106170,263106170,2009
184,17 Again,Comedy,20000000,136267476,116267476,2009
185,A Christmas Carol,Drama,200000000,325233863,125233863,2009
186,The Lovely Bones,Drama,65000000,93525586,28525586,2009
187,Paul Blart: Mall Cop,Action,26000000,183293131,157293131,2009
188,The Box,Thriller,30000000,33333531,3333531,2009
189,Crank: High Voltage,Action,20000000,34560577,14560577,2009
190,Pandorum,Action,33000000,20645327,-12354673,2009
191,Drag Me to Hell,Thriller,30000000,90842646,60842646,2009
192,Knowing,Drama,50000000,155446362,105446362,2009
193,Moon,Drama,5000000,9760104,4760104,2009
194,G-Force,Action,150000000,292817841,142817841,2009
195,The Taking of Pelham 1 2 3,Drama,100000000,150166126,50166126,2009
196,Confessions of a Shopaholic,Comedy,40000000,108332743,68332743,2009
197,Gamer,Action,50000000,40828540,-9171460,2009
198,Couples Retreat,Comedy,70000000,171844840,101844840,2009
199,The Road,Drama,32000000,27635305,-4364695,2009
200,Monsters vs Aliens,Adventure,175000000,381509870,206509870,2009
201,Julie & Julia,Drama,40000000,129540499,89540499,2009
202,Public Enemies,Drama,80000000,214104620,134104620,2009
203,All About Steve,Comedy,15000000,40105542,25105542,2009
204,Alvin and the Chipmunks: The Squeakquel,Comedy,75000000,443140005,368140005,2009
205,After.Life,Drama,4500000,3606395,-893605,2009
206,Bride Wars,Comedy,30000000,114663461,84663461,2009
207,Precious,Drama,10000000,63647833,53647833,2009
208,State of Play,Action,60000000,87784194,27784194,2009
209,"I Love You, Man",Comedy,41000000,91636986,50636986,2009
210,The Informant!,Drama,22000000,35424826,13424826,2009
211,Case 39,Thriller,27000000,29000000,2000000,2009
212,The Boat That Rocked,Drama,50000000,36348784,-13651216,2009
213,Daybreakers,Action,20000000,51416464,31416464,2009
214,Love Happens,Drama,18000000,36133014,18133014,2009
215,Push,Action,38000000,45465299,7465299,2009
216,The Young Victoria,Drama,35000000,27409889,-7590111,2009
217,Whiteout,Action,40000000,12206028,-27793972,2009
218,12 Rounds,Drama,20000000,17280326,-2719674,2009
219,3 Idiots,Drama,9000000,70000000,61000000,2009
220,Transformers: Revenge of the Fallen,Action,150000000,836297228,686297228,2009
221,The Men Who Stare at Goats,Comedy,24000000,68729358,44729358,2009
222,Ninja Assassin,Action,40000000,60462347,20462347,2009
223,Bandslam,Drama,20000000,5210988,-14789012,2009
224,Where the Wild Things Are,Family,100000000,100086793,86793,2009
225,It's Complicated,Comedy,85000000,219103655,134103655,2009
226,Invictus,Drama,60000000,122233971,62233971,2009
227,Planet 51,Comedy,70000000,104945765,34945765,2009
228,Life During Wartime,Drama,4500000,744816,-3755184,2009
229,Ondine,Drama,12000000,1644755,-10355245,2009
230,Old Dogs,Comedy,35000000,92219310,57219310,2009
231,Agora,Drama,70000000,39041505,-30958495,2009
232,The Boondock Saints II: All Saints Day,Action,8000000,10629321,2629321,2009
233,Leaves of Grass,Drama,9000000,985117,-8014883,2009
234,An Education,Drama,7500000,26096852,18596852,2009
235,Funny People,Drama,75000000,61458982,-13541018,2009
236,Up in the Air,Drama,25000000,163670000,138670000,2009
237,Astro Boy,Action,65000000,44091067,-20908933,2009
238,The International,Drama,50000000,60161391,10161391,2009
239,Fast & Furious,Drama,85000000,363164265,278164265,2009
240,Hannah Montana: The Movie,Drama,35000000,155545279,120545279,2009
241,Aliens in the Attic,Comedy,45000000,57881056,12881056,2009
242,The Collector,Thriller,3400000,9444018,6044018,2009
243,Women in Trouble,Drama,3000000,18097,-2981903,2009
244,The Fourth Kind,Thriller,10000000,42333295,32333295,2009
245,Solitary Man,Drama,15000000,5024782,-9975218,2009
246,The Disappearance of Alice Creed,Drama,800000,867714,67714,2009
247,Duplicity,Thriller,78146652,60000000,-18146652,2009
248,Bright Star,Drama,8500000,4440055,-4059945,2009
249,Adventureland,Comedy,9500000,17164377,7664377,2009
250,Extract,Comedy,8000000,10848783,2848783,2009
251,The Messenger,Drama,6500000,1521261,-4978739,2009
252,My Life in Ruins,Comedy,17000000,20455276,3455276,2009
253,My Sister's Keeper,Drama,30000000,95714875,65714875,2009
254,The Soloist,Drama,60000000,31720158,-28279842,2009
255,Surrogates,Action,80000000,122444772,42444772,2009
256,Obsessed,Drama,20000000,73830340,53830340,2009
257,Tetro,Drama,15000000,113221,-14886779,2009
258,Solomon Kane,Action,45000000,7810000,-37190000,2009
259,Survival of the Dead,Science Fiction,4000000,143191,-3856809,2009
260,X-Men Origins: Wolverine,Action,150000000,341131793,191131793,2009
261,Black Dynamite,Action,2900000,296557,-2603443,2009
262,New in Town,Comedy,8000000,29010817,21010817,2009
263,The Joneses,Drama,10000000,7022728,-2977272,2009
264,Fired Up!,Comedy,20000000,18599102,-1400898,2009
265,Wanted,Action,75,134,59,2009
266,World's Greatest Dad,Comedy,10000000,295750,-9704250,2009
267,Post Grad,Comedy,15000000,6405245,-8594755,2009
268,Stolen Lives,Drama,2000000,7306,-1992694,2009
269,The Grudge 3,Thriller,5000000,38610009,33610009,2009
270,Mao's Last Dancer,Drama,25000000,20719451,-4280549,2009
271,Inception,Action,160000000,825500000,665500000,2010
272,Iron Man 2,Action,200000000,623933331,423933331,2010
273,Alice in Wonderland,Adventure,200000000,1025467110,825467110,2010
274,Black Swan,Drama,13000000,327803731,314803731,2010
275,Harry Potter and the Deathly Hallows: Part 1,Adventure,250000000,954305868,704305868,2010
276,Despicable Me,Action,69000000,543513985,474513985,2010
277,The Expendables,Action,80000000,274470394,194470394,2010
278,How to Train Your Dragon,Adventure,165000000,494878759,329878759,2010
279,Shutter Island,Drama,80000000,294804195,214804195,2010
280,TRON: Legacy,Action,170000000,400062763,230062763,2010
281,Tangled,Family,260000000,591794936,331794936,2010
282,Toy Story 3,Comedy,200000000,1063171911,863171911,2010
283,Salt,Action,110000000,293329073,183329073,2010
284,Easy A,Comedy,8000000,74952305,66952305,2010
285,The Tourist,Action,100000000,278346189,178346189,2010
286,Prince of Persia: The Sands of Time,Action,150000000,335154643,185154643,2010
287,Robin Hood,Action,200000000,310669540,110669540,2010
288,True Grit,Drama,38000000,252276927,214276927,2010
289,Clash of the Titans,Action,125000000,232713139,107713139,2010
290,The Sorcerer's Apprentice,Drama,150000000,215283742,65283742,2010
291,The Social Network,Drama,40000000,224920315,184920315,2010
292,Scott Pilgrim vs. the World,Action,60000000,47664559,-12335441,2010
293,Little Fockers,Comedy,100000000,310650585,210650585,2010
294,Shrek Forever After,Comedy,165000000,752600867,587600867,2010
295,The A-Team,Action,110000000,177238796,67238796,2010
296,Machete,Action,20000000,31327899,11327899,2010
297,Grown Ups,Comedy,80000000,271430189,191430189,2010
298,Date Night,Comedy,55000000,152263880,97263880,2010
299,The Town,Drama,37000000,154026136,117026136,2010
300,The Twilight Saga: Eclipse,Drama,68000000,698491347,630491347,2010
301,Megamind,Action,130000000,321885765,191885765,2010
302,The Last Airbender,Action,150000000,318502923,168502923,2010
303,The Other Guys,Action,100000000,170432927,70432927,2010
304,Insidious,Thriller,1500000,97009150,95509150,2010
305,Step Up 3D,Drama,30000000,159291809,129291809,2010
306,The King's Speech,Drama,15000000,414211549,399211549,2010
307,Love & Other Drugs,Drama,30000000,102820008,72820008,2010
308,The Way Back,Drama,30000000,20348249,-9651751,2010
309,Repo Men,Action,32000000,18409891,-13590109,2010
310,Last Night,Drama,7000000,7644937,644937,2010
311,Knight and Day,Action,117000000,261930431,144930431,2010
312,Eat Pray Love,Drama,60000000,204594016,144594016,2010
313,Blue Valentine,Drama,1000000,12355734,11355734,2010
314,The Bounty Hunter,Action,40000000,136000000,96000000,2010
315,Leap Year,Comedy,19000000,29922472,10922472,2010
316,Green Zone,Drama,100000000,94882889,-5117111,2010
317,The Back-Up Plan,Comedy,35000000,77477008,42477008,2010
318,The Switch,Drama,19000000,49830607,30830607,2010
319,Valentine's Day,Comedy,52000000,216485654,164485654,2010
320,Don't Be Afraid of the Dark,Thriller,25000000,36993168,11993168,2010
321,Saw 3D,Crime,20000000,136150434,116150434,2010
322,The Karate Kid,Drama,40000000,357852395,317852395,2010
323,Due Date,Drama,65000000,211780824,146780824,2010
324,Wild Target,Action,8000000,3453043,-4546957,2010
325,From Paris with Love,Action,52000000,52615806,615806,2010
326,It's Kind of a Funny Story,Drama,8000000,6491240,-1508760,2010
327,The Next Three Days,Drama,30000000,51148651,21148651,2010
328,A Nightmare on Elm Street,Thriller,35000000,115664037,80664037,2010
329,The Losers,Action,25000000,23580000,-1420000,2010
330,The Fighter,Drama,25000000,9190869,-15809131,2010
331,Get Him to the Greek,Comedy,40000000,90029656,50029656,2010
332,Jonah Hex,Drama,47000000,10539000,-36461000,2010
333,Vampires Suck,Comedy,20000000,80547866,60547866,2010
334,Killers,Action,75000000,98159963,23159963,2010
335,Nanny McPhee and the Big Bang,Comedy,35000000,93246388,58246388,2010
336,Hot Tub Time Machine,Comedy,36000000,64572262,28572262,2010
337,Let Me In,Drama,20000000,24145613,4145613,2010
338,Flipped,Drama,14000000,1755212,-12244788,2010
339,Legend of the Guardians: The Owls of Ga'Hoole,Adventure,80000000,140073390,60073390,2010
340,Takers,Drama,32000000,69055695,37055695,2010
341,Burlesque,Drama,55000000,89519773,34519773,2010
342,The Company Men,Drama,15000000,4882577,-10117423,2010
343,Going the Distance,Drama,32000000,42045846,10045846,2010
344,Paranormal Activity 2,Thriller,3000000,177512032,174512032,2010
345,Never Let Me Go,Drama,15000000,9455232,-5544768,2010
346,Cop Out,Action,30000000,55583804,25583804,2010
347,Monsters,Drama,500000,4242978,3742978,2010
348,Life as We Know It,Drama,38000000,105610124,67610124,2010
349,Centurion,Drama,12000000,6814789,-5185211,2010
350,Beginners,Drama,3200000,5332926,2132926,2010
351,Shelter,Thriller,22000000,851517,-21148483,2010
352,Stone,Drama,22000000,9479718,-12520282,2010
353,Piranha 3D,Comedy,24000000,83188165,59188165,2010
354,Morning Glory,Drama,40000000,58785180,18785180,2010
355,Conviction,Drama,12500000,6732980,-5767020,2010
356,The Last Exorcism,Drama,1800000,67738090,65938090,2010
357,Fair Game,Drama,22000000,24188922,2188922,2010
358,The Ward,Thriller,10000000,498974,-9501026,2010
359,Buried,Drama,1987650,19152480,17164830,2010
360,Dinner for Schmucks,Comedy,69000000,86387857,17387857,2010
361,The Kids Are All Right,Drama,4000000,34705850,30705850,2010
362,Skyline,Science Fiction,10000000,66821036,56821036,2010
363,The Debt,Drama,20000000,45636368,25636368,2010
364,Winter's Bone,Drama,2000000,13831503,11831503,2010
365,Cats & Dogs 2 : The Revenge of Kitty Galore,Comedy,85000000,112483764,27483764,2010
366,MacGruber,Action,10000000,6110000,-3890000,2010
367,How Do You Know,Drama,120000000,48668907,-71331093,2010
368,Rubber,Drama,500000,98017,-401983,2010
369,She's Out of My League,Comedy,20000000,49779728,29779728,2010
370,London Boulevard,Drama,25000000,4644108,-20355892,2010
371,The Conspirator,Drama,25000000,15478800,-9521200,2010
372,Hesher,Drama,7000000,382946,-6617054,2010
373,Wall Street: Money Never Sleeps,Drama,70000000,134748021,64748021,2010
374,Everything Must Go,Drama,5000000,2614773,-2385227,2010
375,Alpha and Omega,Family,20000000,39300000,19300000,2010
376,Yogi Bear,Comedy,80000000,201584141,121584141,2010
377,Super,Drama,2500000,324138,-2175862,2010
378,Country Strong,Drama,15000000,20529194,5529194,2010
379,"Tomorrow, When the War Began",Drama,27000000,16504936,-10495064,2010
380,Devil,Thriller,10000000,33583175,23583175,2010
381,Halo Legends,Action,100000,1000000,900000,2010
382,Barney's Version,Drama,30000000,8454301,-21545699,2010
383,Dirty Girl,Drama,4000000,55125,-3944875,2010
384,Furry Vengeance,Comedy,35000000,39340177,4340177,2010
385,Casino Jack,Drama,12500000,1083683,-11416317,2010
386,Dylan Dog: Dead of Night,Action,20000000,4634062,-15365938,2010
387,Howl,Drama,30000,617000,587000,2010
388,The Perfect Game,Drama,12500000,3878993,-8621007,2010
389,Stake Land,Drama,650000,33245,-616755,2010
390,The Warrior's Way,Action,425000000,11087569,-413912431,2010
391,Inhale,Drama,10000000,55089,-9944911,2010
392,Four Lions,Drama,967686,4270000,3302314,2010
393,The Extra Man,Comedy,7000000,453079,-6546921,2010
394,Resident Evil: Afterlife,Action,60000000,296221663,236221663,2010
395,Vanishing on 7th Street,Drama,10000000,1068682,-8931318,2010
396,Secretariat,Drama,35000000,60251371,25251371,2010
397,Boy,Drama,3,43,40,2010
398,Fight Club,Drama,63000000,100853753,37853753,1999
399,The Matrix,Action,63000000,463517383,400517383,1999
400,American Beauty,Drama,15000000,356296601,341296601,1999
401,Star Wars: Episode I - The Phantom Menace,Action,115000000,924317558,809317558,1999
402,The Mummy,Action,80000000,415885488,335885488,1999
403,The Green Mile,Drama,60000000,284600000,224600000,1999
404,The World Is Not Enough,Action,135000000,361832400,226832400,1999
405,Entrapment,Drama,66000000,212404396,146404396,1999
406,Toy Story 2,Comedy,90000000,485015179,395015179,1999
407,Notting Hill,Comedy,42000000,363889678,321889678,1999
408,Boys Don't Cry,Drama,2000000,11540607,9540607,1999
409,Eyes Wide Shut,Drama,65000000,162091208,97091208,1999
410,End of Days,Action,100000000,211989043,111989043,1999
411,The Cider House Rules,Drama,24000000,88545092,64545092,1999
412,The Boondock Saints,Action,6000000,30471,-5969529,1999
413,The Virgin Suicides,Drama,6000000,10409377,4409377,1999
414,Dogma,Comedy,10000000,30652890,20652890,1999
415,Magnolia,Drama,37000000,48451803,11451803,1999
416,The Talented Mr. Ripley,Drama,40000000,128798265,88798265,1999
417,Man on the Moon,Drama,82000000,47434430,-34565570,1999
418,Anywhere But Here,Drama,23000000,18653615,-4346385,1999
419,The Lord of the Rings: The Fellowship of the Ring,Action,93000000,871368364,778368364,2001
420,Harry Potter and the Philosopher's Stone,Adventure,125000000,976475550,851475550,2001
421,"Monsters, Inc.",Comedy,115000000,562816256,447816256,2001
422,Shrek,Comedy,60000000,484409218,424409218,2001
423,Ocean's Eleven,Thriller,85000000,450717150,365717150,2001
424,Atlantis: The Lost Empire,Adventure,120000000,186053725,66053725,2001
425,A Beautiful Mind,Drama,60000000,313542341,253542341,2001
426,Cats & Dogs,Comedy,60000000,93375151,33375151,2001
427,AntiTrust,Drama,30000000,17833000,-12167000,2001
428,K-PAX,Drama,48000000,50315140,2315140,2001
429,Angel Eyes,Drama,53000000,29700000,-23300000,2001
430,Exit Wounds,Action,50000000,79958599,29958599,2001
431,How High,Comedy,12000000,31155435,19155435,2001
432,Ghosts of Mars,Action,28000000,14010832,-13989168,2001
433,Osmosis Jones,Action,75000000,13596911,-61403089,2001
434,Human Nature,Drama,6000000,705308,-5294692,2001
435,Knockaround Guys,Thriller,15000000,12000000,-3000000,2001
436,Wet Hot American Summer,Comedy,5000000,295206,-4704794,2001
437,The Dark Knight,Drama,185000000,1001921825,816921825,2008
438,WALLÂ·E,Family,180000000,521311860,341311860,2008
439,Iron Man,Action,140000000,585174222,445174222,2008
440,Indiana Jones and the Kingdom of the Crystal Skull,Action,185000000,786636033,601636033,2008
441,Twilight,Drama,37000000,392616625,355616625,2008
442,Quantum of Solace,Action,200000000,586090727,386090727,2008
443,Kung Fu Panda,Family,130000000,631744560,501744560,2008
444,Sex Drive,Comedy,19000000,18755936,-244064,2008
445,The Curious Case of Benjamin Button,Drama,150000000,333932083,183932083,2008
446,Gran Torino,Drama,33000000,269958228,236958228,2008
447,Madagascar: Escape 2 Africa,Family,150000000,603900354,453900354,2008
448,Jumper,Adventure,85000000,222231186,137231186,2008
449,Wanted,Action,75000000,258270008,183270008,2008
450,Slumdog Millionaire,Drama,15000000,377910544,362910544,2008
451,Hancock,Action,150000000,624029371,474029371,2008
452,The Hurt Locker,Drama,15000000,42000000,27000000,2008
453,Tropic Thunder,Action,92000000,188072649,96072649,2008
454,The Boy in the Striped Pyjamas,Drama,12500000,20416563,7916563,2008
455,Rambo,Action,50000000,113244290,63244290,2008
456,Death Race,Action,45000000,73762516,28762516,2008
457,Seven Pounds,Drama,55000000,168167691,113167691,2008
458,Cloverfield,Action,25000000,170764026,145764026,2008
459,Bolt,Comedy,150000000,309979994,159979994,2008
460,Forgetting Sarah Marshall,Drama,30000000,105173115,75173115,2008
461,Marley & Me,Comedy,60000000,244082376,184082376,2008
462,27 Dresses,Comedy,30000000,160259319,130259319,2008
463,Inkheart,Adventure,60000000,57490374,-2509626,2008
464,21,Drama,35000000,69823199,34823199,2008
465,Fool's Gold,Comedy,70000000,111231041,41231041,2008
466,Never Back Down,Drama,20000000,41627431,21627431,2008
467,Pineapple Express,Action,27000000,101624843,74624843,2008
468,The Wrestler,Drama,6000000,44703995,38703995,2008
469,Punisher: War Zone,Action,20500000,10089373,-10410627,2008
470,Max Payne,Action,35000000,85416905,50416905,2008
471,Vantage Point,Drama,40000000,151161491,111161491,2008
472,Zack and Miri Make a Porno,Comedy,24000000,42105111,18105111,2008
473,Get Smart,Action,80000000,230685453,150685453,2008
474,Babylon A.D.,Action,70000000,72108608,2108608,2008
475,In Bruges,Drama,15000000,32002538,17002538,2008
476,Changeling,Drama,55000000,113020255,58020255,2008
477,Harold & Kumar Escape from Guantanamo Bay,Comedy,12000000,43493123,31493123,2008
478,The House Bunny,Comedy,25000000,70442940,45442940,2008
479,The Love Guru,Comedy,62000000,41819064,-20180936,2008
480,Speed Racer,Action,120000000,93945766,-26054234,2008
481,The Forbidden Kingdom,Action,55000000,127906624,72906624,2008
482,Traitor,Drama,22000000,23530831,1530831,2008
483,You Don't Mess With the Zohan,Action,90000000,201596308,111596308,2008
484,Untraceable,Drama,35000000,32483410,-2516590,2008
485,The Strangers,Thriller,9000000,82391145,73391145,2008
486,Milk,Drama,20000000,54586584,34586584,2008
487,City of Ember,Adventure,55000000,17869048,-37130952,2008
488,RockNRolla,Action,18000000,25739015,7739015,2008
489,The Eye,Drama,12000000,56309766,44309766,2008
490,Bangkok Dangerous,Action,45000000,42487390,-2512610,2008
491,Meet the Spartans,Comedy,30000000,84646831,54646831,2008
492,The Spirit,Action,60000000,39031337,-20968663,2008
493,The Informers,Drama,18000000,382174,-17617826,2008
494,The Happening,Thriller,60000000,163403799,103403799,2008
495,Sex and the City,Drama,65000000,415252786,350252786,2008
496,The Rocker,Comedy,15000000,8762890,-6237110,2008
497,The Tale of Despereaux,Comedy,60000000,50877145,-9122855,2008
498,The Secret Life of Bees,Drama,11000000,38105395,27105395,2008
499,Ong Bak 2,Action,8500000,8936663,436663,2008
500,Pride and Glory,Drama,30000000,31148328,1148328,2008
501,Baby Mama,Comedy,30000000,63833449,33833449,2008
502,Brideshead Revisited,Drama,20000000,13204291,-6795709,2008
503,The Brothers Bloom,Drama,20000000,5530764,-14469236,2008
504,Meet Dave,Comedy,60000000,50650079,-9349921,2008
505,Justice League: The New Frontier,Action,3500000,5231128,1731128,2008
506,ÐÐ´Ð¼Ð¸Ñ€Ð°Ð»ÑŠ,Drama,2000000,38135878,36135878,2008
507,Space Chimps,Family,37000000,63800345,26800345,2008
508,What Just Happened,Drama,25000000,6673422,-18326578,2008
509,Disaster Movie,Action,25000000,14109284,-10890716,2008
510,My Best Friend's Girl,Comedy,20000000,36620508,16620508,2008
511,The Midnight Meat Train,Drama,15000000,3533227,-11466773,2008
512,W.,Drama,25100000,29506464,4406464,2008
513,Fireproof,Drama,500000,33456317,32956317,2008
514,Smart People,Drama,7000000,10569964,3569964,2008
515,Oorlogswinter,Drama,4000000,530048,-3469952,2008
516,Bottle Shock,Drama,5000000,4040588,-959412,2008
517,Sleep Dealer,Drama,2500000,107559,-2392441,2008
518,Captain America: The First Avenger,Action,140000000,370569774,230569774,2011
519,Harry Potter and the Deathly Hallows: Part 2,Adventure,125000000,1327817822,1202817822,2011
520,Pirates of the Caribbean: On Stranger Tides,Action,380000000,1021683000,641683000,2011
521,Rise of the Planet of the Apes,Drama,93000000,482860185,389860185,2011
522,Thor,Action,150000000,444115007,294115007,2011
523,In Time,Action,40000000,173930596,133930596,2011
524,Drive Angry,Action,50000000,28931401,-21068599,2011
525,The Mechanic,Action,40000000,51070807,11070807,2011
526,Source Code,Thriller,32000000,147332697,115332697,2011
527,Mission: Impossible - Ghost Protocol,Action,145000000,694713380,549713380,2011
528,"Crazy, Stupid, Love.",Drama,50000000,142851197,92851197,2011
529,The Girl with the Dragon Tattoo,Drama,90000000,232617430,142617430,2011
530,Limitless,Thriller,27000000,161849455,134849455,2011
531,Kung Fu Panda 2,Family,150000000,665692281,515692281,2011
532,Just Go With It,Comedy,80000000,214918407,134918407,2011
533,Horrible Bosses,Comedy,35000000,117000000,82000000,2011
534,Real Steel,Drama,110000000,299268508,189268508,2011
535,Friends with Benefits,Comedy,35000000,150483765,115483765,2011
536,Bad Teacher,Comedy,20000000,216197492,196197492,2011
537,Sherlock Holmes: A Game of Shadows,Action,125000000,334615000,209615000,2011
538,Cars 2,Comedy,200000000,559852396,359852396,2011
539,Green Lantern,Action,200000000,219851172,19851172,2011
540,The Hangover Part II,Comedy,80000000,254455986,174455986,2011
541,No Strings Attached,Comedy,25000000,147780440,122780440,2011
542,The Adventures of Tintin,Action,130000000,371940071,241940071,2011
543,Bridesmaids,Comedy,32500000,288383523,255883523,2011
544,Hall Pass,Comedy,36000000,83160734,47160734,2011
545,Super 8,Thriller,50000000,260095987,210095987,2011
546,Sucker Punch,Action,82000000,89792502,7792502,2011
547,Red Riding Hood,Thriller,42000000,89162162,47162162,2011
548,The Twilight Saga: Breaking Dawn - Part 1,Adventure,110000000,712171856,602171856,2011
549,The Tree of Life,Drama,32000000,54674226,22674226,2011
550,I Am Number Four,Action,50000000,144492830,94492830,2011
551,Rio,Comedy,90000000,484635760,394635760,2011
552,The Artist,Drama,15000000,133432856,118432856,2011
553,Zookeeper,Comedy,80000000,169852759,89852759,2011
554,Cowboys & Aliens,Action,163000000,174822325,11822325,2011
555,War Horse,Drama,66000000,177584879,111584879,2011
556,50/50,Drama,8000000,39187783,31187783,2011
557,Rango,Comedy,135000000,245724603,110724603,2011
558,The Change-Up,Comedy,52000000,75450437,23450437,2011
559,Hugo,Drama,170000000,185770160,15770160,2011
560,The Lincoln Lawyer,Drama,40000000,85412898,45412898,2011
561,Ghost Rider: Spirit of Vengeance,Action,57000000,149217355,92217355,2011
562,One Day,Drama,15000000,59389433,44389433,2011
563,The Rite,Drama,37000000,96047633,59047633,2011
564,Winnie the Pooh,Family,30000000,14460000,-15540000,2011
565,The Three Musketeers,Action,75000000,132274484,57274484,2011
566,Priest,Action,60000000,78309131,18309131,2011
567,Young Adult,Drama,12000000,22939027,10939027,2011
568,Warrior,Drama,25000000,23057115,-1942885,2011
569,Abduction,Action,35000000,82087155,47087155,2011
570,Unknown,Action,30000000,130786397,100786397,2011
571,The Adjustment Bureau,Thriller,50200000,127869379,77669379,2011
572,Immortals,Drama,75000000,226904017,151904017,2011
573,Like Crazy,Drama,250000,3542353,3292353,2011
574,Larry Crowne,Drama,30000000,36160375,6160375,2011
575,Paul,Comedy,40000000,97552050,57552050,2011
576,Colombiana,Drama,40000000,60965854,20965854,2011
577,Battle: Los Angeles,Action,70000000,202466756,132466756,2011
578,Machine Gun Preacher,Action,30000000,2527904,-27472096,2011
579,Jack and Jill,Comedy,79000000,149673788,70673788,2011
580,What's Your Number?,Comedy,20000000,30426096,10426096,2011
581,Season of the Witch,Action,40000000,88100000,48100000,2011
582,My Week with Marilyn,Drama,6400000,35057696,28657696,2011
583,We Bought a Zoo,Drama,50000000,120081841,70081841,2011
584,The Darkest Hour,Action,30000000,64626786,34626786,2011
585,The Help,Drama,25000000,124272124,99272124,2011
586,The Grey,Drama,25000000,77278331,52278331,2011
587,Moneyball,Drama,50000000,110206216,60206216,2011
588,The Roommate,Drama,16000000,40492759,24492759,2011
589,The Green Hornet,Action,120000000,227817248,107817248,2011
590,Something Borrowed,Drama,35000000,59901913,24901913,2011
591,Conan the Barbarian,Action,90000000,48795021,-41204979,2011
592,Johnny English Reborn,Action,45000000,160078586,115078586,2011
593,Contagion,Drama,60000000,135458097,75458097,2011
594,Beastly,Drama,17000000,43165571,26165571,2011
595,A Very Harold & Kumar Christmas,Comedy,19000000,35387212,16387212,2011
596,The Thing,Thriller,35000000,28128670,-6871330,2011
597,Tower Heist,Action,75000000,152930623,77930623,2011
598,Your Highness,Action,49900000,26121638,-23778362,2011
599,Apollo 18,Thriller,5000000,25562924,20562924,2011
600,Fright Night,Comedy,17000000,24922237,7922237,2011
601,Happy Feet Two,Comedy,130000000,150406466,20406466,2011
602,Mars Needs Moms,Adventure,150000000,38992758,-111007242,2011
603,Attack the Block,Action,14350531,3964682,-10385849,2011
604,Diary of a Wimpy Kid: Rodrick Rules,Comedy,21000000,72417394,51417394,2011
605,Extremely Loud & Incredibly Close,Drama,40000000,55247881,15247881,2011
606,The Beaver,Drama,21000000,970816,-20029184,2011
607,Straw Dogs,Thriller,25000000,10324441,-14675559,2011
608,The Best Exotic Marigold Hotel,Drama,10000000,136836156,126836156,2011
609,The Smurfs,Comedy,110000000,563749323,453749323,2011
610,Hanna,Action,30000000,63782078,33782078,2011
611,Flypaper,Comedy,5000000,3142154,-1857846,2011
612,Margin Call,Drama,3500000,19504039,16004039,2011
613,Gnomeo & Juliet,Family,36000000,189712432,153712432,2011
614,Blitz,Action,15774948,741875,-15033073,2011
615,The Descendants,Drama,20000000,177243185,157243185,2011
616,The Guard,Action,6000000,19560274,13560274,2011
617,Our Idiot Brother,Drama,10000000,17273593,7273593,2011
618,The Ledge,Drama,10000000,610986,-9389014,2011
619,Footloose,Drama,24000000,63543328,39543328,2011
620,Carnage,Drama,25000000,27603069,2603069,2011
621,The Ides of March,Drama,12500000,75993061,63493061,2011
622,Transformers: Dark of the Moon,Action,195000000,1123746996,928746996,2011
623,The Dilemma,Drama,70000000,67112664,-2887336,2011
624,Take Me Home Tonight,Drama,19000000,6928068,-12071932,2011
625,The Muppets,Comedy,45000000,165184237,120184237,2011
626,Trust,Drama,9500000,120000,-9380000,2011
627,Arthur,Comedy,40000000,45735397,5735397,2011
628,The Eagle,Drama,25000000,27122040,2122040,2011
629,W.E.,Drama,15000000,868439,-14131561,2011
630,The Innkeepers,Thriller,750000,78396,-671604,2011
631,Restless,Drama,8000000,163265,-7836735,2011
632,J. Edgar,Drama,35000000,84606030,49606030,2011
633,Sanctum,Action,30000000,108609310,78609310,2011
634,I Don't Know How She Does It,Comedy,24000000,30551495,6551495,2011
635,A Dangerous Method,Drama,15000000,27462041,12462041,2011
636,Soul Surfer,Drama,18000000,47088990,29088990,2011
637,30 Minutes or Less,Action,28000000,40547440,12547440,2011
638,Hoodwinked Too! Hood VS. Evil,Comedy,30000000,13521829,-16478171,2011
639,Water for Elephants,Drama,38000000,114156230,76156230,2011
640,Dream House,Drama,50000000,38502340,-11497660,2011
641,"Love, Wedding, Marriage",Comedy,1,1378,1377,2011
642,Rampart,Drama,12000000,972512,-11027488,2011
643,Take Shelter,Drama,5000000,3099314,-1900686,2011
644,Prom,Comedy,8000000,10130000,2130000,2011
645,Courageous,Drama,1000000,34522221,33522221,2011
646,Killer Joe,Drama,10000000,3665069,-6334931,2011
647,"Big Mommas: Like Father, Like Son",Action,32000000,83615414,51615414,2011
648,From Prada to Nada,Drama,93,2500000,2499907,2011
649,Dolphin Tale,Drama,37000000,95404397,58404397,2011
650,Xin shao lin si,Drama,29000000,33662874,4662874,2011
651,Fast Five,Action,125000000,626137675,501137675,2011
652,In the Land of Blood and Honey,Drama,10000000,303877,-9696123,2011
653,Jumping the Broom,Comedy,6600000,37710610,31110610,2011
654,Wuthering Heights,Drama,8000000,100915,-7899085,2011
655,Your Sister's Sister,Drama,125000,3200000,3075000,2011
656,Win Win,Drama,10831173,10654385,-176788,2011
657,L!fe Happens,Comedy,930000,30905,-899095,2011
658,The Iron Lady,Drama,13000000,114956699,101956699,2011
659,The Music Never Stopped,Drama,4000000,253899,-3746101,2011
660,Shark Night,Thriller,28000000,10126458,-17873542,2011
661,Hobo with a Shotgun,Action,3000000,672648,-2327352,2011
662,Atlas Shrugged Part I,Drama,15000000,4627375,-10372625,2011
663,Albert Nobbs,Drama,8000000,5634828,-2365172,2011
664,Weekend,Drama,8000,469947,461947,2011
665,Justin Bieber: Never Say Never,Family,13000000,98441954,85441954,2011
666,Bellflower,Drama,17000,101236,84236,2011
667,Life in a Day,Drama,45202,225861,180659,2011
668,X-Men: First Class,Action,160000000,344420111,184420111,2011
669,The Lord of the Rings: The Two Towers,Action,79000000,926287400,847287400,2002
670,Ice Age,Comedy,59000000,383257136,324257136,2002
671,The Bourne Identity,Drama,60000000,214034224,154034224,2002
672,Resident Evil,Action,33000000,102441078,69441078,2002
673,Spider-Man,Action,139000000,821708551,682708551,2002
674,Star Wars: Episode II - Attack of the Clones,Action,120000000,649398328,529398328,2002
675,Men in Black II,Action,140000000,441818803,301818803,2002
676,The Pianist,Drama,35000000,120072577,85072577,2002
677,Blade II,Action,54000000,155010032,101010032,2002
678,Gangs of New York,Drama,100000000,193772504,93772504,2002
679,Panic Room,Drama,48000000,196397415,148397415,2002
680,8 Mile,Drama,41000000,215000000,174000000,2002
681,Bend It Like Beckham,Drama,3500159,76578641,73078482,2002
682,A Walk to Remember,Drama,11000000,41227069,30227069,2002
683,About a Boy,Drama,27000000,129000000,102000000,2002
684,Collateral Damage,Drama,85000000,78382433,-6617567,2002
685,Austin Powers in Goldmember,Action,63000000,296633907,233633907,2002
686,The Scorpion King,Action,60000000,165333180,105333180,2002
687,The Sum of All Fears,Drama,68,193,125,2002
688,Adaptation.,Drama,19000000,32801173,13801173,2002
689,The Time Machine,Action,80000000,123729176,43729176,2002
690,The Sweetest Thing,Comedy,43000000,68696770,25696770,2002
691,Showtime,Action,85000000,77741732,-7258268,2002
692,The Lion King,Drama,45000000,788241776,743241776,1994
693,Clerks,Comedy,27000,3151130,3124130,1994
694,Four Weddings and a Funeral,Drama,6000000,254700832,248700832,1994
695,Heavenly Creatures,Drama,5000000,3049135,-1950865,1994
696,PrÃªt-Ã -Porter,Drama,15000000,11300653,-3699347,1994
697,The Avengers,Action,220000000,1519557910,1299557910,2012
698,Underworld: Awakening,Action,70000000,132400000,62400000,2012
699,The Dark Knight Rises,Drama,250000000,1081041287,831041287,2012
700,Django Unchained,Drama,100000000,425368238,325368238,2012
701,Skyfall,Action,200000000,1108561013,908561013,2012
702,The Bourne Legacy,Action,130000000,276572938,146572938,2012
703,The Hobbit: An Unexpected Journey,Action,250000000,1017003568,767003568,2012
704,Prometheus,Adventure,130000000,403170142,273170142,2012
705,Silver Linings Playbook,Drama,21000000,205738714,184738714,2012
706,The Amazing Spider-Man,Action,215000000,752215857,537215857,2012
707,Brave,Action,185000000,538983207,353983207,2012
708,Snow White and the Huntsman,Drama,170000000,396600000,226600000,2012
709,21 Jump Street,Action,42000000,201585328,159585328,2012
710,Life of Pi,Drama,120000000,609016565,489016565,2012
711,Ice Age: Continental Drift,Comedy,95000000,877244782,782244782,2012
712,Ted,Comedy,50000000,549368315,499368315,2012
713,Jack Reacher,Drama,60000000,218340595,158340595,2012
714,Lo imposible,Drama,42000000,180274123,138274123,2012
715,Wreck-It Ralph,Comedy,165000000,471222889,306222889,2012
716,Pitch Perfect,Comedy,17000000,115350426,98350426,2012
717,Men in Black 3,Action,225000000,624026776,399026776,2012
718,The Hunger Games,Adventure,75000000,691210692,616210692,2012
719,Total Recall,Action,125000000,198802074,73802074,2012
720,Cloud Atlas,Drama,102000000,130482868,28482868,2012
721,The Expendables 2,Action,100000000,312573423,212573423,2012
722,Dark Shadows,Comedy,150000000,245527149,95527149,2012
723,The Perks of Being a Wallflower,Drama,13000000,33400000,20400000,2012
724,Argo,Drama,44500000,232324128,187824128,2012
725,American Reunion,Comedy,50000000,234989584,184989584,2012
726,Magic Mike,Drama,7000000,167221571,160221571,2012
727,The Cabin in the Woods,Thriller,30000000,66486080,36486080,2012
728,Rise of the Guardians,Family,145000000,306941670,161941670,2012
729,Journey 2: The Mysterious Island,Action,79000000,355692760,276692760,2012
730,Safe,Action,30000000,40346186,10346186,2012
731,Moonrise Kingdom,Drama,16000000,68263166,52263166,2012
732,Dredd,Action,50000000,41037742,-8962258,2012
733,Les MisÃ©rables,Drama,61000000,441809770,380809770,2012
734,John Carter,Action,260000000,284139100,24139100,2012
735,Looper,Action,30000000,47042000,17042000,2012
736,Zero Dark Thirty,Drama,40000000,132820716,92820716,2012
737,Haywire,Thriller,23000000,33372606,10372606,2012
738,Wrath of the Titans,Adventure,150000000,301000000,151000000,2012
739,Act of Valor,Action,12000000,81272766,69272766,2012
740,Hotel Transylvania,Comedy,85000000,358375603,273375603,2012
741,What to Expect When You're Expecting,Drama,40000000,79700000,39700000,2012
742,The Dictator,Comedy,65000000,179379533,114379533,2012
743,Iron Sky,Action,7500000,8135031,635031,2012
744,Contraband,Drama,25000000,63100000,38100000,2012
745,Lawless,Drama,26000000,53676580,27676580,2012
746,Rock of Ages,Drama,75000000,59418613,-15581387,2012
747,The Pirates! In an Adventure with Scientists!,Comedy,60000000,118338361,58338361,2012
748,The Five-Year Engagement,Comedy,30000000,53909751,23909751,2012
749,This Is 40,Comedy,35000000,88058786,53058786,2012
750,Lockout,Action,20000000,32204030,12204030,2012
751,Wanderlust,Comedy,35000000,24159934,-10840066,2012
752,The Woman in Black,Drama,17000000,127730736,110730736,2012
753,Frankenweenie,Comedy,39000000,81491068,42491068,2012
754,That's My Boy,Comedy,70000000,58058367,-11941633,2012
755,Safe House,Action,85000000,208076205,123076205,2012
756,Savages,Drama,45000000,47000000,2000000,2012
757,Man on a Ledge,Action,42000000,46221189,4221189,2012
758,Seven Psychopaths,Comedy,15000000,19422261,4422261,2012
759,Big Miracle,Drama,40000000,24719215,-15280785,2012
760,Disconnect,Drama,10000000,3428048,-6571952,2012
761,Piranha 3DD,Comedy,5000000,8493728,3493728,2012
762,Killing Them Softly,Thriller,15000000,37930465,22930465,2012
763,Red Dawn,Action,65000000,44806783,-20193217,2012
764,The Three Stooges,Comedy,30000000,54819301,24819301,2012
765,A Thousand Words,Drama,40000000,22044277,-17955723,2012
766,One for the Money,Action,40000000,36893721,-3106279,2012
767,ParaNorman,Comedy,60000000,107139399,47139399,2012
768,For Greater Glory - The True Story of Cristiada,Drama,12000000,9622846,-2377154,2012
769,Red Tails,Drama,58000000,50365377,-7634623,2012
770,The Lords of Salem,Thriller,1500000,1165882,-334118,2012
771,Premium Rush,Action,35000000,31083599,-3916401,2012
772,Bachelorette,Comedy,3000000,11947954,8947954,2012
773,The Words,Drama,6000000,13231461,7231461,2012
774,On the Road,Drama,25000000,8784318,-16215682,2012
775,The Devil Inside,Thriller,1000000,101758490,100758490,2012
776,Hit & Run,Action,2000000,14400000,12400000,2012
777,Deadfall,Drama,12000000,66351,-11933649,2012
778,Beasts of the Southern Wild,Drama,1800000,21107746,19307746,2012
779,The Apparition,Thriller,17000000,9627492,-7372508,2012
780,Robot & Frank,Drama,2500000,3325038,825038,2012
781,Cosmopolis,Drama,20500000,6063556,-14436444,2012
782,Resident Evil: Retribution,Action,65000000,240159255,175159255,2012
783,Foodfight!,Action,65000000,73706,-64926294,2012
784,The Lord of the Rings: The Return of the King,Action,94000000,1118888979,1024888979,2003
785,Underworld,Action,22000000,95708457,73708457,2003
786,Pirates of the Caribbean: The Curse of the Black Pearl,Action,140000000,655011224,515011224,2003
787,Kill Bill: Vol. 1,Action,30000000,180949000,150949000,2003
788,Finding Nemo,Family,94000000,864625978,770625978,2003
789,Bruce Almighty,Comedy,80000000,484572835,404572835,2003
790,Love Actually,Drama,40000000,244931766,204931766,2003
791,Daredevil,Action,78000000,179179718,101179718,2003
792,The Italian Job,Action,60000000,176070171,116070171,2003
793,Bad Santa,Drama,23000000,76488889,53488889,2003
794,A Man Apart,Drama,36000000,44350926,8350926,2003
795,The School of Rock,Comedy,35000000,131282949,96282949,2003
796,Master and Commander: The Far Side of the World,Adventure,150000000,212011111,62011111,2003
797,Old School,Comedy,24000000,87055349,63055349,2003
798,S.W.A.T.,Action,80000000,116643346,36643346,2003
799,Gothika,Thriller,40000000,141591324,101591324,2003
800,21 Grams,Drama,20000000,60427839,40427839,2003
801,The Rundown,Action,85000000,80916492,-4083508,2003
802,Seabiscuit,Drama,87000000,148336445,61336445,2003
803,Dreamcatcher,Drama,68000000,75715436,7715436,2003
804,Monster,Drama,8000000,60378584,52378584,2003
805,Gigli,Drama,54000000,7266209,-46733791,2003
806,House of the Dead,Action,7000000,13818181,6818181,2003
807,Young Adam,Drama,6400000,2500000,-3900000,2003
808,Swimming Pool,Thriller,7800000,22441323,14641323,2003
809,Calendar Girls,Comedy,10000000,96542059,86542059,2003
810,Mambo Italiano,Comedy,4361898,3031801,-1330097,2003
811,Ghosts of the Abyss,Family,13000000,17040871,4040871,2003
812,Alex & Emma,Comedy,30000000,15368897,-14631103,2003
813,Titanic,Drama,200000000,1845034188,1645034188,1997
814,Men in Black,Action,90000000,589390539,499390539,1997
815,Tomorrow Never Dies,Action,110000000,333011068,223011068,1997
816,Good Will Hunting,Drama,10000000,225933435,215933435,1997
817,Home Alone 3,Comedy,32000000,79082515,47082515,1997
818,Chasing Amy,Drama,250000,12021272,11771272,1997
819,Contact,Drama,90000000,171120329,81120329,1997
820,Cop Land,Drama,15000000,44862187,29862187,1997
821,Frozen,Adventure,150000000,1274219009,1124219009,2013
822,Gravity,Drama,105000000,716392705,611392705,2013
823,Thor: The Dark World,Action,170000000,479765000,309765000,2013
824,Iron Man 3,Action,200000000,1215439994,1015439994,2013
825,The Hunger Games: Catching Fire,Action,130000000,847423452,717423452,2013
826,The Wolf of Wall Street,Drama,100000000,392000694,292000694,2013
827,Pacific Rim,Action,180000000,407602906,227602906,2013
828,Oblivion,Action,120000000,286168572,166168572,2013
829,The Hobbit: The Desolation of Smaug,Adventure,250000000,958400000,708400000,2013
830,Man of Steel,Action,225000000,662845518,437845518,2013
831,Her,Drama,23000000,47351251,24351251,2013
832,Despicable Me 2,Comedy,76000000,970761885,894761885,2013
833,Riddick,Action,38000000,98337295,60337295,2013
834,The Conjuring,Thriller,13000000,318000141,305000141,2013
835,A Good Day to Die Hard,Action,92000000,304654182,212654182,2013
836,World War Z,Drama,200000000,531865000,331865000,2013
837,Ender's Game,Action,110000000,125537191,15537191,2013
838,2 Guns,Drama,61000000,131940411,70940411,2013
839,Percy Jackson: Sea of Monsters,Adventure,90000000,174578751,84578751,2013
840,Prisoners,Drama,46000000,122126687,76126687,2013
841,American Hustle,Drama,40000000,251171807,211171807,2013
842,Hansel & Gretel: Witch Hunters,Action,50000000,224803475,174803475,2013
843,The Mortal Instruments: City of Bones,Drama,60000000,90565421,30565421,2013
844,Lone Survivor,Drama,40000000,149295601,109295601,2013
845,R.I.P.D.,Action,130000000,61648500,-68351500,2013
846,Spring Breakers,Drama,5000000,31724284,26724284,2013
847,The Call,Thriller,13000000,68572378,55572378,2013
848,The Place Beyond the Pines,Drama,15000000,35485608,20485608,2013
849,The Croods,Comedy,135000000,585178928,450178928,2013
850,Escape Plan,Action,50000000,122915111,72915111,2013
851,Carrie,Drama,30000000,82394288,52394288,2013
852,Captain Phillips,Drama,55000000,95000000,40000000,2013
853,Jack the Giant Slayer,Action,195000000,197687603,2687603,2013
854,Runner Runner,Drama,30000000,62616646,32616646,2013
855,This Is the End,Action,32000000,126041322,94041322,2013
856,The Lone Ranger,Action,255000000,89289910,-165710090,2013
857,Gangster Squad,Drama,60000000,105200903,45200903,2013
858,Stoker,Drama,12000000,12077441,77441,2013
859,The Spectacular Now,Drama,2500000,6854611,4354611,2013
860,Oz: The Great and Powerful,Adventure,200000000,491868548,291868548,2013
861,Turbo,Family,135000000,282570682,147570682,2013
862,Redemption,Action,20000000,8352885,-11647115,2013
863,Pain & Gain,Action,25000000,86175291,61175291,2013
864,Escape from Planet Earth,Comedy,40000000,74597643,34597643,2013
865,A Haunted House,Comedy,2500000,60141683,57641683,2013
866,Side Effects,Drama,30000000,63372757,33372757,2013
867,La migliore offerta,Drama,13500000,19255873,5755873,2013
868,Broken City,Drama,56000000,19701164,-36298836,2013
869,Walking With Dinosaurs,Adventure,80000000,126546518,46546518,2013
870,No One Lives,Thriller,2900000,74918,-2825082,2013
871,The Smurfs 2,Comedy,105000000,347434178,242434178,2013
872,The Wolverine,Action,120000000,415440673,295440673,2013
873,Jobs,Drama,12000000,35931410,23931410,2013
874,In a World...,Comedy,1000000,2963902,1963902,2013
875,The To Do List,Comedy,1500000,3566225,2066225,2013
876,Fast & Furious 6,Action,160000000,788679850,628679850,2013
877,Khumba,Adventure,20000000,27187375,7187375,2013
878,Black Nativity,Drama,17500000,7018189,-10481811,2013
879,Wolf Creek 2,Thriller,8000000,9630444,1630444,2013
880,The East,Drama,6500000,2401510,-4098490,2013
881,The Canyons,Drama,250000,56825,-193175,2013
882,The Internship,Comedy,58000000,44000000,-14000000,2013
883,Ð¡Ñ‚Ð°Ð»Ð¸Ð½Ð³Ñ€Ð°Ð´,Action,30000000,68129518,38129518,2013
884,Back to the Future,Comedy,19000000,381109762,362109762,1985
885,A View to a Kill,Action,30000000,152427960,122427960,1985
886,Harry Potter and the Goblet of Fire,Adventure,150000000,895921036,745921036,2005
887,Batman Begins,Drama,150000000,374218673,224218673,2005
888,V for Vendetta,Action,54000000,132511035,78511035,2005
889,Sin City,Action,40000000,158733820,118733820,2005
890,Star Wars: Episode III - Revenge of the Sith,Action,113000000,850000000,737000000,2005
891,The Island,Action,126000000,162949164,36949164,2005
892,Constantine,Drama,100000000,230427240,130427240,2005
893,The Pacifier,Drama,56000000,113006880,57006880,2005
894,Memoirs of a Geisha,Drama,85000000,162242962,77242962,2005
895,The 40 Year Old Virgin,Comedy,26000000,109449237,83449237,2005
896,Chicken Little,Comedy,150000000,314432665,164432665,2005
897,Kingdom of Heaven,Drama,130000000,211643158,81643158,2005
898,Pride & Prejudice,Drama,28000000,121147947,93147947,2005
899,Brokeback Mountain,Drama,14000000,178043761,164043761,2005
900,The Legend of Zorro,Drama,75000000,142400065,67400065,2005
901,Elektra,Action,43000000,56681566,13681566,2005
902,Corpse Bride,Romance,40000000,117195061,77195061,2005
903,The Curse of the Were-Rabbit,Comedy,30000000,192452832,162452832,2005
904,Rumor Has It...,Comedy,70000000,88933562,18933562,2005
905,Four Brothers,Action,45000000,92374674,47374674,2005
906,Cinderella Man,Drama,88000000,108539911,20539911,2005
907,Hoodwinked!,Comedy,15000000,51053787,36053787,2005
908,Proof,Drama,20000000,7535331,-12464669,2005
909,The Interpreter,Action,80000000,162944923,82944923,2005
910,An Unfinished Life,Drama,30000000,18618284,-11381716,2005
911,The Dukes of Hazzard,Action,50000000,110803676,60803676,2005
912,Syriana,Drama,50000000,94000000,44000000,2005
913,Derailed,Drama,22000000,57479076,35479076,2005
914,"Good Night, and Good Luck.",Drama,7000000,54600000,47600000,2005
915,Fun with Dick and Jane,Comedy,100000000,202026112,102026112,2005
916,Unleashed,Action,45000000,50871113,5871113,2005
917,Two for the Money,Drama,35000000,30526509,-4473491,2005
918,Harsh Times,Drama,2000000,5967038,3967038,2005
919,Broken Flowers,Drama,10000000,45742101,35742101,2005
920,A Sound of Thunder,Action,80000000,5989640,-74010360,2005
921,The Fog,Thriller,18000000,46201432,28201432,2005
922,BloodRayne,Action,25000000,2405420,-22594580,2005
923,Capote,Drama,7000000,49084830,42084830,2005
924,Hard Candy,Drama,950000,7022209,6072209,2005
925,Brick,Drama,475000,3919254,3444254,2005
926,Sky High,Comedy,35000000,86369815,51369815,2005
927,Everything is Illuminated,Drama,7000000,2697930,-4302070,2005
928,Transamerica,Drama,1000000,13350369,12350369,2005
929,Boogeyman,Drama,20000000,67192859,47192859,2005
930,Rent,Drama,40000000,31670620,-8329380,2005
931,Man-Thing,Action,7500000,143000,-7357000,2005
932,Tamara,Thriller,4750000,206871,-4543129,2005
933,North Country,Drama,35000000,25224242,-9775758,2005
934,Down in the Valley,Drama,8000000,852872,-7147128,2005
935,Tsotsi,Drama,3000000,9879971,6879971,2005
936,Underworld: Evolution,Action,50000000,111340801,61340801,2006
937,Pirates of the Caribbean: Dead Man's Chest,Action,200000000,1065659812,865659812,2006
938,Cars,Comedy,120000000,461983149,341983149,2006
939,Casino Royale,Action,150000000,599045960,449045960,2006
940,The Da Vinci Code,Thriller,125000000,758239851,633239851,2006
941,Ice Age: The Meltdown,Comedy,80000000,660940780,580940780,2006
942,Mission: Impossible III,Action,150000000,397850012,247850012,2006
943,The Devil Wears Prada,Drama,35000000,326551094,291551094,2006
944,The Departed,Drama,90000000,289847354,199847354,2006
945,The Holiday,Comedy,85000000,194168700,109168700,2006
946,The Prestige,Drama,40000000,109676311,69676311,2006
947,Children of Men,Drama,76000000,69959751,-6040249,2006
948,Borat: Cultural Learnings of America for Make Benefit Glorious Nation of Kazakhstan,Comedy,18000000,261572744,243572744,2006
949,The Break-Up,Comedy,52000000,204999686,152999686,2006
950,Inside Man,Drama,45000000,184376254,139376254,2006
951,Perfume: The Story of a Murderer,Drama,50000000,132180323,82180323,2006
952,The Fountain,Drama,35000000,15304890,-19695110,2006
953,Rocky Balboa,Drama,24000000,155721132,131721132,2006
954,Flushed Away,Comedy,149000000,64459316,-84540684,2006
955,The Wild,Family,80000000,37384046,-42615954,2006
956,Eragon,Action,100000000,249288105,149288105,2006
957,The Lake House,Drama,40000000,114830111,74830111,2006
958,The Ant Bully,Comedy,50000000,55181129,5181129,2006
959,The Hills Have Eyes,Thriller,15000000,69623713,54623713,2006
960,The Good Shepherd,Drama,85000000,59908565,-25091435,2006
961,Smokin' Aces,Action,17000000,57103895,40103895,2006
962,All the King's Men,Drama,55000000,9450897,-45549103,2006
963,Talladega Nights: The Ballad of Ricky Bobby,Comedy,72500000,162966177,90466177,2006
964,The Pursuit of Happyness,Drama,55000000,307077295,252077295,2006
965,Marie Antoinette,Drama,40000000,60474340,20474340,2006
966,Freedomland,Drama,37665000,14655628,-23009372,2006
967,Nacho Libre,Comedy,32000000,80197993,48197993,2006
968,Poseidon,Drama,160000000,181674817,21674817,2006
969,Fur: An Imaginary Portrait of Diane Arbus,Drama,16800000,2281089,-14518911,2006
970,"You, Me and Dupree",Comedy,54000000,130431368,76431368,2006
971,Little Miss Sunshine,Drama,8000000,100523181,92523181,2006
972,Little Man,Comedy,64000000,101595121,37595121,2006
973,The Omen,Drama,25000000,119188334,94188334,2006
974,Letters from Iwo Jima,Drama,19000000,68673228,49673228,2006
975,A Scanner Darkly,Thriller,8500000,5480996,-3019004,2006
976,Stranger Than Fiction,Drama,30000000,53653224,23653224,2006
977,Open Season,Adventure,85000000,197309027,112309027,2006
978,Dreamgirls,Drama,70000000,154937680,84937680,2006
979,Southland Tales,Drama,17000000,374743,-16625257,2006
980,The Fast and the Furious: Tokyo Drift,Drama,85000000,158468292,73468292,2006
981,Pulse,Thriller,38000000,29907685,-8092315,2006
982,Black Snake Moan,Drama,15000000,10903846,-4096154,2006
983,The Shaggy Dog,Comedy,50000000,61112916,11112916,2006
984,Aquamarine,Comedy,12000000,23006849,11006849,2006
985,Scoop,Comedy,4000000,31584901,27584901,2006
986,Notes on a Scandal,Drama,15000000,49469904,34469904,2006
987,Kidulthood,Drama,994000,165000,-829000,2006
988,The Queen,Drama,15000000,123384128,108384128,2006
989,The Good German,Drama,32000000,5914908,-26085092,2006
990,Running Scared,Drama,15000000,9500000,-5500000,2006
991,Catch and Release,Drama,25000000,16158487,-8841513,2006
992,The Grudge 2,Thriller,20000000,39143839,19143839,2006
993,Tenacious D in The Pick of Destiny,Comedy,22000000,13405595,-8594405,2006
994,When a Stranger Calls,Thriller,15000000,66966987,51966987,2006
995,Dhoom 2,Drama,11000000,46396427,35396427,2006
996,Fido,Drama,8000000,426224,-7573776,2006
997,Facing the Giants,Drama,100000,10178331,10078331,2006
998,The History Boys,Drama,4000000,13401952,9401952,2006
999,This Is England,Drama,2380000,8176544,5796544,2006
1000,IndigÃ¨nes,Drama,14500000,22963701,8463701,2006
1001,Akeelah and the Bee,Drama,8000000,18948425,10948425,2006
1002,Eternal Sunshine of the Spotless Mind,Drama,20000000,72258126,52258126,2004
1003,The Notebook,Drama,29000000,115603229,86603229,2004
1004,The Incredibles,Action,92000000,631442092,539442092,2004
1005,The Bourne Supremacy,Drama,75000000,288500217,213500217,2004
1006,"I, Robot",Action,120000000,347234916,227234916,2004
1007,Mean Girls,Comedy,17000000,129042871,112042871,2004
1008,Van Helsing,Action,160000000,300257475,140257475,2004
1009,Hellboy,Action,66000000,99318987,33318987,2004
1010,The Polar Express,Adventure,165000000,305875730,140875730,2004
1011,Shrek 2,Comedy,150000000,919838758,769838758,2004
1012,Ocean's Twelve,Thriller,110000000,362744280,252744280,2004
1013,Meet the Fockers,Comedy,80000000,516642939,436642939,2004
1014,The Day After Tomorrow,Action,125000000,544272402,419272402,2004
1015,Blade: Trinity,Action,65000000,128905366,63905366,2004
1016,The Terminal,Drama,60000000,219417255,159417255,2004
1017,Million Dollar Baby,Drama,30000000,216763646,186763646,2004
1018,Sky Captain and the World of Tomorrow,Action,70000000,57958696,-12041304,2004
1019,Crash,Drama,6500000,98410061,91910061,2004
1020,A Cinderella Story,Comedy,19000000,70067909,51067909,2004
1021,AVP: Alien vs. Predator,Action,70000000,171183863,101183863,2004
1022,Banlieue 13,Action,12000000,9584131,-2415869,2004
1023,Spider-Man 2,Action,200000000,783766341,583766341,2004
1024,Along Came Polly,Comedy,42000000,171963386,129963386,2004
1025,The Punisher,Drama,33000000,54700105,21700105,2004
1026,Dawn of the Dead,Action,28000000,102356381,74356381,2004
1027,The Chronicles of Riddick,Action,105000000,115772733,10772733,2004
1028,After the Sunset,Drama,60000000,61347797,1347797,2004
1029,Before Sunset,Drama,2700000,15992615,13292615,2004
1030,Cellular,Action,25000000,56422687,31422687,2004
1031,Shall We Dance?,Drama,50000000,170128460,120128460,2004
1032,Primer,Drama,7000,424760,417760,2004
1033,Home on the Range,Comedy,110000000,103951461,-6048539,2004
1034,Hotel Rwanda,Drama,17500000,38000000,20500000,2004
1035,Team America: World Police,Action,32000000,50907422,18907422,2004
1036,Sideways,Drama,16000000,109502303,93502303,2004
1037,The Passion of the Christ,Drama,30000000,611899420,581899420,2004
1038,Ray,Drama,40000000,124731534,84731534,2004
1039,Friday Night Lights,Drama,30000000,61255921,31255921,2004
1040,Raise Your Voice,Drama,15000000,14867514,-132486,2004
1041,Mindhunters,Thriller,27000000,21148829,-5851171,2004
1042,Agent Cody Banks 2: Destination London,Comedy,26000000,28818995,2818995,2004
1043,A Dirty Shame,Comedy,15000000,1914166,-13085834,2004
1044,Mean Creek,Drama,500000,603943,103943,2004
1045,The Godfather,Drama,6000000,245066411,239066411,1972
1046,The Empire Strikes Back,Action,18000000,538400000,520400000,1980
1047,Pirates of the Caribbean: At World's End,Action,300000000,961000000,661000000,2007
1048,Harry Potter and the Order of the Phoenix,Adventure,150000000,938212738,788212738,2007
1049,Ratatouille,Comedy,150000000,623722818,473722818,2007
1050,The Bourne Ultimatum,Drama,70000000,442824138,372824138,2007
1051,I Am Legend,Drama,150000000,585349010,435349010,2007
1052,National Treasure: Book of Secrets,Action,130000000,457363168,327363168,2007
1053,Spider-Man 3,Action,258000000,890871626,632871626,2007
1054,The Mist,Thriller,18000000,57096190,39096190,2007
1055,Stardust,Adventure,70000000,135560026,65560026,2007
1056,Death Proof,Action,25000000,25037897,37897,2007
1057,Into the Wild,Drama,15000000,56255142,41255142,2007
1058,300,Action,65000000,422610419,357610419,2007
1059,Ghost Rider,Action,110000000,228738393,118738393,2007
1060,Juno,Drama,7500000,231411584,223911584,2007
1061,Bridge to Terabithia,Drama,60000000,137587063,77587063,2007
1062,Shooter,Drama,61000000,95696996,34696996,2007
1063,American Gangster,Drama,100000000,266465037,166465037,2007
1064,Shrek the Third,Comedy,160000000,798958165,638958165,2007
1065,Sweeney Todd: The Demon Barber of Fleet Street,Drama,50000000,152000000,102000000,2007
1066,Superbad,Comedy,20000000,169860655,149860655,2007
1067,Alvin and the Chipmunks,Comedy,60000000,361366633,301366633,2007
1068,Bee Movie,Comedy,150000000,287594577,137594577,2007
1069,Knocked Up,Drama,30000000,219076518,189076518,2007
1070,The Number 23,Drama,30000000,77566815,47566815,2007
1071,Enchanted,Comedy,85000000,340487652,255487652,2007
1072,Ocean's Thirteen,Thriller,85000000,311312624,226312624,2007
1073,The Simpsons Movie,Comedy,75000000,527068851,452068851,2007
1074,Charlie Wilson's War,Drama,75000000,119000410,44000410,2007
1075,The Kingdom,Drama,70000000,86658558,16658558,2007
1076,Aliens vs Predator: Requiem,Action,40000000,41797066,1797066,2007
1077,30 Days of Night,Thriller,30000000,75505973,45505973,2007
1078,The Golden Compass,Adventure,180000000,372234864,192234864,2007
1079,Once,Drama,160000,20710513,20550513,2007
1080,The Brave One,Drama,70000000,69766619,-233381,2007
1081,Disturbia,Drama,20000000,117760134,97760134,2007
1082,August Rush,Drama,25000000,66122026,41122026,2007
1083,Evan Almighty,Comedy,175000000,173000000,-2000000,2007
1084,I Now Pronounce You Chuck & Larry,Comedy,85000000,186072214,101072214,2007
1085,Saw IV,Thriller,10000000,139352633,129352633,2007
1086,Hairspray,Comedy,50000000,90450008,40450008,2007
1087,Shoot 'Em Up,Action,39000000,26820641,-12179359,2007
1088,Eastern Promises,Thriller,51500000,55112356,3612356,2007
1089,Beowulf,Fantasy,70000000,195735876,125735876,2007
1090,No Reservations,Comedy,28000000,92601050,64601050,2007
1091,Surf's Up,Comedy,85000000,149044513,64044513,2007
1092,1408,Thriller,25000000,94679598,69679598,2007
1093,Hitman,Drama,24000000,99965753,75965753,2007
1094,The Game Plan,Comedy,22000000,147880543,125880543,2007
1095,Run Fatboy Run,Comedy,10000000,33000000,23000000,2007
1096,Transformers,Action,150000000,709709780,559709780,2007
1097,The Bucket List,Drama,45000000,175372502,130372502,2007
1098,I Know Who Killed Me,Thriller,12000000,9620399,-2379601,2007
1099,Becoming Jane,Drama,16500000,37311672,20811672,2007
1100,Funny Games,Thriller,15000000,7938872,-7061128,2007
1101,Daddy Day Camp,Comedy,6000000,18197398,12197398,2007
1102,Resident Evil: Extinction,Action,45000000,147717833,102717833,2007
1103,The Assassination of Jesse James by the Coward Robert Ford,Drama,30000000,14711793,-15288207,2007
1104,A Mighty Heart,Drama,16000000,18928871,2928871,2007
1105,Death at a Funeral,Drama,9000000,46,-8999954,2007
1106,Norbit,Comedy,60000000,95673607,35673607,2007
1107,Rendition,Drama,27500000,24748670,-2751330,2007
1108,In the Valley of Elah,Drama,23000000,29541790,6541790,2007
1109,Good Luck Chuck,Drama,25000000,59192128,34192128,2007
1110,In the Land of Women,Drama,10000000,17500000,7500000,2007
1111,Battle for Terra,Action,4000000,6101046,2101046,2007
1112,Freedom Writers,Drama,21000000,41170784,20170784,2007
1113,The Kite Runner,Drama,20000000,73276047,53276047,2007
1114,Dan in Real Life,Drama,25000000,68377859,43377859,2007
1115,License to Wed,Comedy,35000000,69307224,34307224,2007
1116,Michael Clayton,Drama,25000000,92991835,67991835,2007
1117,Lars and the Real Girl,Drama,12000000,11293663,-706337,2007
1118,The Lookout,Drama,16000000,5367030,-10632970,2007
1119,Gone Baby Gone,Drama,19000000,34619699,15619699,2007
1120,Walk Hard: The Dewey Cox Story,Comedy,35000000,18317151,-16682849,2007
1121,Meet Bill,Drama,5000000,346592,-4653408,2007
1122,Things We Lost in the Fire,Drama,16000000,2849142,-13150858,2007
1123,Reign Over Me,Drama,20000000,22222308,2222308,2007
1124,Love in the Time of Cholera,Drama,45000000,4607608,-40392392,2007
1125,I'm Not There.,Drama,20000000,4001121,-15998879,2007
1126,You Kill Me,Comedy,4000000,2426851,-1573149,2007
1127,Son of Rambow,Comedy,4000000,6870249,2870249,2007
1128,December Boys,Drama,4000000,46474,-3953526,2007
1129,Hannibal Rising,Drama,50000000,82169884,32169884,2007
1130,My Name Is Bruce,Comedy,1500000,173066,-1326934,2007
1131,Alien,Action,11000000,104931801,93931801,1979
1132,Apocalypse Now,Drama,31500000,83471511,51971511,1979
1133,Moonraker,Action,34000000,210300000,176300000,1979
1134,Phantasm,Science Fiction,300000,11988469,11688469,1979
1135,The Terminator,Action,6400000,78371200,71971200,1984
1136,Indiana Jones and the Temple of Doom,Action,28000000,333000000,305000000,1984
1137,Ghostbusters,Action,30000000,295212467,265212467,1984
1138,Starman,Drama,22000000,28744356,6744356,1984
1139,Return of the Jedi,Action,32350000,572700000,540350000,1983
1140,Never Say Never Again,Action,36000000,160000000,124000000,1983
1141,Octopussy,Action,27500000,183700000,156200000,1983
1142,WarGames,Thriller,12000000,79567667,67567667,1983
1143,Rumble Fish,Drama,10000000,2494480,-7505520,1983
1144,Se7en,Thriller,33000000,327311859,294311859,1995
1145,Toy Story,Comedy,30000000,361958736,331958736,1995
1146,The Usual Suspects,Drama,6000000,23341568,17341568,1995
1147,GoldenEye,Action,58000000,352194034,294194034,1995
1148,Leaving Las Vegas,Drama,3600000,49800000,46200000,1995
1149,Mighty Morphin Power Rangers: The Movie,Action,15000000,66000000,51000000,1995
1150,Friday,Drama,3500000,28215918,24715918,1995
1151,Strange Days,Drama,42000000,7959291,-34040709,1995
1152,Aladdin,Comedy,28000000,504050219,476050219,1992
1153,A Few Good Men,Drama,40000000,243240178,203240178,1992
1154,Basic Instinct,Thriller,49000000,352927224,303927224,1992
1155,The Crying Game,Drama,3705538,62548947,58843409,1992
1156,Memoirs of an Invisible Man,Drama,40000000,14358033,-25641967,1992
1157,Raiders of the Lost Ark,Action,18000000,389925971,371925971,1981
1158,For Your Eyes Only,Action,28000000,195312802,167312802,1981
1159,The Fox and the Hound,Drama,12000000,29800000,17800000,1981
1160,Escape from New York,Action,6000000,50000000,44000000,1981
1161,Halloween II,Thriller,2500000,25533818,23033818,1981
1162,Clash of the Titans,Adventure,15000000,41092328,26092328,1981
1163,Mission: Impossible,Action,80000000,457696359,377696359,1996
1164,Fargo,Drama,7000000,60611975,53611975,1996
1165,Mars Attacks!,Comedy,70000000,101371017,31371017,1996
1166,Romeo + Juliet,Drama,14500000,147298761,132798761,1996
1167,Space Jam,Drama,80000000,230000000,150000000,1996
1168,Eraser,Drama,100000000,242295562,142295562,1996
1169,From Dusk Till Dawn,Action,19000000,25836616,6836616,1996
1170,Star Trek: First Contact,Action,46000000,150000000,104000000,1996
1171,Escape from L.A.,Action,50000000,42277365,-7722635,1996
1172,Set  It Off,Drama,9000000,41590886,32590886,1996
1173,Evita,Drama,55000000,141047179,86047179,1996
1174,James and the Giant Peach,Adventure,38000000,28921264,-9078736,1996
1175,Emma,Drama,6000000,22231658,16231658,1996
1176,Memento,Thriller,9000000,39723096,30723096,2000
1177,How the Grinch Stole Christmas,Comedy,123000000,345141403,222141403,2000
1178,Mission: Impossible II,Action,125000000,546388105,421388105,2000
1179,U-571,Drama,62000000,127666415,65666415,2000
1180,Erin Brockovich,Drama,52000000,256271286,204271286,2000
1181,Pitch Black,Action,23000000,53187659,30187659,2000
1182,Remember the Titans,Drama,30000000,136706683,106706683,2000
1183,Space Cowboys,Action,65000000,128884132,63884132,2000
1184,Bring It On,Comedy,28000000,90449929,62449929,2000
1185,The Flintstones in Viva Rock Vegas,Comedy,83000000,59468275,-23531725,2000
1186,Vertical Limit,Action,75000000,215663859,140663859,2000
1187,The Kid,Comedy,65000000,69700000,4700000,2000
1188,Ready to Rumble,Drama,24000000,12372410,-11627590,2000
1189,The In Crowd,Thriller,15000000,5217498,-9782502,2000
1190,Blade Runner,Drama,28000000,32768670,4768670,1982
1191,E.T. the Extra-Terrestrial,Adventure,10500000,792910554,782410554,1982
1192,The Thing,Thriller,10000000,13782838,3782838,1982
1193,Blade,Action,45000000,131183530,86183530,1998
1194,The Big Lebowski,Comedy,15000000,27739163,12739163,1998
1195,A Bug's Life,Family,120000000,363398565,243398565,1998
1196,There's Something About Mary,Comedy,23000000,369884651,346884651,1998
1197,American History X,Drama,20000000,23875127,3875127,1998
1198,Meet Joe Black,Drama,90000000,142940100,52940100,1998
1199,Sphere,Science Fiction,75000000,13100000,-61900000,1998
1200,Pi,Drama,60000,3221152,3161152,1998
1201,You've Got Mail,Comedy,65000000,250821495,185821495,1998
1202,"Lock, Stock and Two Smoking Barrels",Comedy,1350000,3897569,2547569,1998
1203,Soldier,Action,75000000,14567883,-60432117,1998
1204,Indiana Jones and the Last Crusade,Action,48000000,474171806,426171806,1989
1205,Back to the Future Part II,Action,40000000,332000000,292000000,1989
1206,Licence to Kill,Action,32000000,156167015,124167015,1989
1207,Bill & Ted's Excellent Adventure,Comedy,10000000,40485039,30485039,1989
1208,Beauty and the Beast,Romance,25000000,377350553,352350553,1991
1209,Harley Davidson and the Marlboro Man,Action,23000000,7434726,-15565274,1991
1210,They Live,Action,4000000,13008928,9008928,1988
1211,Phantasm II,Action,3000000,7282851,4282851,1988
1212,Dirty Dancing,Drama,6000000,213954274,207954274,1987
1213,Spaceballs,Comedy,22700000,38119483,15419483,1987
1214,The Living Daylights,Action,40000000,191185897,151185897,1987
1215,The Man with the Golden Gun,Action,7000000,97572000,90572000,1974
1216,Jaws,Thriller,7000000,470654000,463654000,1975
1217,Monty Python and the Holy Grail,Comedy,400000,5028948,4628948,1975
1218,The Rocky Horror Picture Show,Comedy,1200000,112892319,111692319,1975
1219,Dr. No,Action,1100000,59600000,58500000,1962
1220,Goldfinger,Action,3500000,124900000,121400000,1964
1221,A Hard Day's Night,Comedy,500000,1000549,500549,1964
1222,Diamonds Are Forever,Action,7200000,116000000,108800000,1971
1223,Dirty Harry,Action,4000000,35976000,31976000,1971
1224,THX 1138,Drama,777000,2437000,1660000,1971
1225,The Last Picture Show,Drama,1300000,29133000,27833000,1971
1226,Back to the Future Part III,Action,40000000,244527583,204527583,1990
1227,The Godfather: Part III,Drama,54000000,136766062,82766062,1990
1228,The Hunt for Red October,Action,30,200,170,1990
1229,Home Alone,Comedy,18000000,476684675,458684675,1990
1230,"One, Two, Three",Comedy,3000000,4000000,1000000,1961
1231,Schindler's List,Drama,22000000,321265768,299265768,1993
1232,Jurassic Park,Adventure,63000000,920100000,857100000,1993
1233,Demolition Man,Action,57000000,159055768,102055768,1993
1234,The Three Musketeers,Action,30000000,53898845,23898845,1993
1235,Kalifornia,Thriller,9000000,2395231,-6604769,1993
1236,Body of Evidence,Drama,30000000,13273595,-16726405,1993
1237,Poetic Justice,Drama,14000000,27515786,13515786,1993
1238,You Only Live Twice,Action,9500000,111584787,102084787,1967
1239,From Russia With Love,Action,2500000,78898765,76398765,1963
1240,Big Trouble in Little China,Action,25000000,11000000,-14000000,1986
1241,The Exorcist,Drama,8000000,441306145,433306145,1973
1242,Live and Let Die,Action,7000000,161777836,154777836,1973
1243,Thunderball,Action,11000000,141195658,130195658,1965
1244,On Her Majesty's Secret Service,Action,7000000,81974493,74974493,1969
1245,Halloween,Thriller,300000,70000000,69700000,1978
1246,Animal House,Comedy,2700000,141000000,138300000,1978
